0 0 0 0 0 0 0 0 0 0 1 1 0 0 0 0 0 0 0 0
0 0 1 0 1 1 1 1 1 0 1 0 1 0 0 0 0 0 1 0
5 1 1 0 0 0 0 0 1 0 1 1 1 0 0 0 0 0 1 1
0 1 1 0 1 1 1 1 1 0 1 0 1 0 1 1 1 1 1 0
0 1 1 0 1 0 0 1 0 0 1 0 1 0 1 0 0 1 0 0
0 0 1 1 1 0 0 1 1 1 1 0 1 1 1 0 0 1 1 9
0 0 0 1 0 0 1 0 0 0 1 1 0 1 0 0 1 0 0 0 
0 0 0 1 0 0 1 0 1 1 0 1 0 1 0 0 1 0 0 0
0 0 0 1 1 1 1 0 1 1 1 1 0 1 1 1 1 0 0 0
0 0 0 0 0 0 0 0 0 0 0 0 0 0 0 0 0 0 0 0